Tanggal,Jam,Tanggal Jam,Meninggal,Sembuh,Self Isolation,Masih Perawatan,Total Pasien,Positif Harian,Positif Aktif,Sembuh Harian,Tanpa Gejala,Bergejala,Belum Ada Data
3/1/2020,,,0,0,0,0,0,0,0,0,,,
3/2/2020,,,0,0,0,0,0,0,0,0,,,
3/3/2020,,,1,0,0,2,3,3,2,0,,,
3/4/2020,,,1,0,0,2,3,0,2,0,,,
3/5/2020,,,3,0,0,4,7,4,4,0,,,
3/6/2020,,,3,0,0,4,7,0,4,0,,,
3/7/2020,,,3,0,0,4,7,0,4,0,,,
3/8/2020,,,3,0,0,4,7,0,4,0,,,
3/9/2020,,,3,0,0,31,34,27,31,0,,,
3/10/2020,,,3,0,0,31,34,0,31,0,,,
3/11/2020,,,3,0,0,33,36,2,33,0,,,
3/12/2020,,,5,0,0,57,62,26,57,0,,,
3/13/2020,,,7,0,0,65,72,10,65,0,,,
3/14/2020,,,9,0,0,70,79,7,70,0,,,
3/15/2020,,,11,0,0,84,95,16,84,0,,,
3/16/2020,,,12,0,7,78,97,2,85,0,,,
3/17/2020,,,12,0,27,83,122,25,110,0,,,
3/18/2020,,,15,12,42,91,160,38,133,12,,,
3/19/2020,,,19,13,57,121,210,50,178,1,,,
3/20/2020,,,20,13,66,125,224,14,191,0,,,
3/21/2020,,,23,17,71,157,268,44,228,4,,,
3/22/2020,,,29,21,77,177,304,36,254,4,,,
3/23/2020,,,29,22,79,225,355,51,304,1,,,
3/24/2020,,,34,23,109,260,426,71,369,1,,,
3/25/2020,,,43,27,112,290,472,46,402,4,,,
3/26/2020,,,49,29,113,324,515,43,437,2,,,
3/27/2020,,,57,31,132,346,566,51,478,2,,,
3/28/2020,,,62,43,134,364,603,37,498,12,,,
3/29/2020,,,67,48,151,435,701,98,586,5,,,
3/30/2020,,,78,49,151,449,727,26,600,1,,,
3/31/2020,,,84,49,157,451,741,14,608,0,,,
4/1/2020,,,90,51,176,499,816,75,675,2,,,
4/2/2020,,,95,54,195,565,909,93,760,3,,,
4/3/2020,,,98,56,209,627,990,81,836,2,,,
4/4/2020,,,99,58,223,691,1071,81,914,2,,,
4/5/2020,,,123,64,279,685,1151,80,964,6,,,
4/6/2020,,,131,68,317,783,1299,148,1100,4,,,
4/7/2020,,,141,69,338,895,1443,144,1233,1,,,
4/8/2020,,,144,75,357,976,1552,109,1333,6,,,
4/9/2020,,,155,82,405,1077,1719,167,1482,7,,,
4/10/2020,,,156,82,433,1139,1810,91,1572,0,,,
4/11/2020,,,168,142,441,1152,1903,93,1593,60,,,
4/12/2020,,,195,142,468,1277,2082,179,1745,0,,,
4/13/2020,,,209,142,521,1370,2242,160,1891,0,,,
4/14/2020,,,243,163,558,1385,2349,107,1943,21,,,
4/15/2020,,,246,164,613,1424,2447,98,2037,1,,,
4/16/2020,,,248,202,619,1601,2670,223,2220,38,,,
4/17/2020,,,250,203,643,1727,2823,153,2370,1,,,
4/18/2020,,,257,206,670,1769,2902,79,2439,3,,,
4/19/2020,,,292,207,695,1839,3033,131,2534,1,,,
4/20/2020,,,297,237,752,1826,3112,79,2578,30,,,
4/21/2020,,,305,286,753,1935,3279,167,2688,49,,,
4/22/2020,,,308,291,815,1985,3399,120,2800,5,,,
4/23/2020,,,316,292,888,2010,3506,107,2898,1,,,
4/24/2020,,,331,327,959,1988,3605,99,2947,35,,,
4/25/2020,,,350,334,1050,1947,3681,76,2997,7,,,
4/26/2020,,,357,338,1099,1952,3746,65,3051,4,,,
4/27/2020,,,375,338,1169,1950,3832,86,3119,0,,,
4/28/2020,,,379,341,1206,2024,3950,118,3230,3,,,
4/29/2020,,,381,412,1238,2002,4033,83,3240,71,,,
4/30/2020,,,381,412,1272,2073,4138,105,3345,0,,,
5/1/2020,,,393,427,1312,2151,4283,145,3463,15,,,
5/2/2020,,,400,562,1304,2089,4355,72,3393,135,,,
5/3/2020,,,410,622,1323,2062,4417,62,3385,60,,,
5/4/2020,,,412,650,1330,2080,4472,55,3410,28,,,
5/5/2020,,,414,711,1370,2146,4641,169,3516,61,,,
5/6/2020,,,420,713,1381,2195,4709,68,3576,2,,,
5/7/2020,,,430,718,1431,2196,4775,66,3627,5,,,
5/8/2020,,,431,763,1426,2281,4901,126,3707,45,,,
5/9/2020,,,437,767,1442,2312,4958,57,3754,4,,,
5/10/2020,,,444,803,1533,2360,5140,182,3893,36,,,
5/11/2020,,,453,836,1648,2258,5195,55,3906,33,,,
5/12/2020,,,457,1262,1741,1843,5303,108,3584,426,,,
5/13/2020,,,461,1277,1866,1833,5437,134,3699,15,,,
5/14/2020,,,466,1279,1995,1877,5617,180,3872,2,,,
5/15/2020,,,474,1286,2019,1900,5679,62,3919,7,,,
5/16/2020,,,475,1292,2120,1908,5795,116,4028,6,,,
5/17/2020,,,478,1295,2217,1932,5922,127,4149,3,,,
5/18/2020,,,483,1301,2266,1946,5996,74,4212,6,,,
5/19/2020,,,487,1417,2213,1936,6053,57,4149,116,,,
5/20/2020,,,493,1425,2263,1969,6150,97,4232,8,,,
5/21/2020,,,498,1536,2231,1955,6220,70,4186,111,,,
5/22/2020,,,501,1558,2282,1975,6316,96,4257,22,,,
5/23/2020,,,504,1587,2346,2006,6443,127,4352,29,,,
5/24/2020,,,505,1594,2431,2031,6561,118,4462,7,,,
5/25/2020,,,506,1648,2430,2044,6628,67,4474,54,,,
5/26/2020,,,508,1678,2459,2044,6689,61,4503,30,,,
5/27/2020,,,510,1698,2584,2034,6826,137,4618,20,,,
5/28/2020,,,514,1719,2641,2055,6929,103,4696,21,,,
5/29/2020,,,517,1807,2722,2007,7053,124,4729,88,,,
5/30/2020,,,519,2003,2781,1848,7151,98,4629,196,,,
5/31/2020,,,520,2102,2827,1823,7272,121,4650,99,,,
6/1/2020,,,521,2246,2822,1794,7383,111,4616,144,,,
6/2/2020,,,525,2405,2786,1743,7459,76,4529,159,,,
6/3/2020,,,529,2534,2777,1699,7539,80,4476,129,,,
6/4/2020,,,530,2607,2793,1670,7600,61,4463,73,,,
6/5/2020,,,532,2751,2768,1633,7684,84,4401,144,,,
6/6/2020,,,535,2840,2776,1635,7786,102,4411,89,,,
6/7/2020,,,537,3170,2794,1445,7946,160,4239,330,,,
6/8/2020,,,538,3205,2846,1448,8037,91,4294,35,,,
6/9/2020,,,547,3369,2918,1442,8276,239,4360,164,,,
6/10/2020,,,551,3517,2928,1427,8423,147,4355,148,,,
6/11/2020,,,555,3664,2887,1446,8552,129,4333,147,,,
6/12/2020,,,561,3780,2863,1424,8628,76,4287,116,,,
6/13/2020,,,564,3840,2925,1419,8748,120,4344,60,,,
6/14/2020,,,571,4091,2833,1368,8863,115,4201,251,,,
6/15/2020,,,580,4198,2800,1390,8968,105,4190,107,,,
6/16/2020,,,583,4329,2764,1416,9092,124,4180,131,,,
6/17/2020,,,588,4444,2775,1402,9209,117,4177,115,,,
6/18/2020,,,594,4592,2822,1377,9385,176,4199,148,,,
6/19/2020,,,599,4682,2862,1382,9525,140,4244,90,,,
6/20/2020,,,603,4821,2939,1340,9703,178,4279,139,,,
6/21/2020,,,615,5054,2874,1287,9830,127,4161,233,,,
6/22/2020,,,618,5128,2901,1310,9957,127,4211,74,,,
6/23/2020,,,619,5228,2957,1319,10123,166,4276,100,,,
6/24/2020,,,628,5322,2978,1349,10277,154,4327,94,,,
6/25/2020,,,631,5435,3068,1338,10472,195,4406,113,,,
6/26/2020,,,632,5542,3136,1330,10640,168,4466,107,,,
6/27/2020,,,632,5610,3256,1355,10853,213,4611,68,,,
6/28/2020,,,635,5865,3163,1322,10985,132,4485,255,,,
6/29/2020,,,636,6118,3299,1027,11080,95,4326,253,,,
6/30/2020,,,641,6512,3172,951,11276,196,4123,394,,,
7/1/2020,,,644,6680,3269,889,11482,206,4158,168,,,
7/2/2020,,,646,6871,3356,804,11677,195,4160,191,,,
7/3/2020,,,648,7109,3331,736,11824,147,4067,238,,,
7/4/2020,,,650,7377,3366,646,12039,215,4012,268,,,
7/5/2020,,,658,7663,3390,584,12295,256,3974,286,,,
7/6/2020,,,658,8033,3340,495,12526,231,3835,370,,,
7/7/2020,,,664,8277,3379,405,12725,199,3784,244,,,
7/8/2020,,,667,8429,3556,417,13069,344,3973,152,,,
7/9/2020,,,677,8647,3584,451,13359,290,4035,218,,,
7/10/2020,,,684,8825,3613,476,13598,239,4089,178,,,
7/11/2020,,,690,9040,3732,495,13957,359,4227,215,,,
7/12/2020,,,702,9200,3905,554,14361,404,4459,160,,,
7/13/2020,,,710,9408,3924,597,14639,278,4521,208,,,
7/14/2020,,,714,9528,4053,619,14914,275,4672,120,,,
7/15/2020,,,720,9721,4041,691,15173,259,4732,193,,,
7/16/2020,,,722,9857,4110,777,15466,293,4887,136,,,
7/17/2020,,,731,9994,4156,826,15707,241,4982,137,,,
7/18/2020,,,740,10117,4289,892,16038,331,5181,123,,,
7/19/2020,,,748,10444,4236,923,16351,313,5159,327,8503,5362,2486
7/20/2020,,,749,10602,4335,1026,16712,361,5361,158,8356,5760,2596
7/21/2020,,,758,10864,4458,1073,17153,441,5531,262,8577,5832,2744
7/22/2020,,,766,11187,4383,1193,17529,376,5576,323,8767,5962,2800
7/23/2020,,,767,11302,4675,1201,17945,416,5876,115,8770,6283,2892
7/24/2020,,,768,11585,4577,1300,18230,285,5877,283,8770,6283,3177
7/25/2020,,,769,11715,4729,1410,18623,393,6139,130,8939,6332,3352
7/26/2020,,,779,11889,4842,1491,19001,378,6333,174,9120,6460,3421
7/27/2020,,,782,11996,4993,1702,19473,472,6695,107,9348,6621,3504
7/28/2020,,,795,12373,4869,1848,19885,412,6717,377,9348,6621,3916
7/29/2020,,,820,12613,5093,1944,20470,585,7037,240,9620,6960,3890
7/30/2020,,,821,12801,5098,2049,20769,299,7147,188,9625,6854,4290
7/31/2020,,,836,13208,4974,2183,21201,432,7157,407,9753,6996,4452
8/1/2020,,,852,13887,4683,2153,21575,374,6836,679,9718,7110,4747
8/2/2020,,,852,14027,4916,2159,21954,379,7075,140,9879,7245,4830
8/3/2020,,,867,14165,5084,2327,22443,489,7411,138,10099,7406,4938
8/4/2020,,,880,14381,5216,2432,22909,466,7648,216,10079,7560,5270
8/5/2020,,,895,14760,5128,2483,23266,357,7611,379,10279,7617,5370
8/6/2020,,,908,15006,5397,2552,23863,597,7949,246,10450,7636,5777
8/7/2020,,,922,15201,5803,2595,24521,658,8398,195,10570,7836,6115
8/8/2020,,,934,15710,6110,2488,25242,721,8598,509,11106,8077,6059
8/9/2020,,,939,16268,6091,2416,25714,472,8507,558,14143,8077,3494
8/10/2020,,,940,16446,6252,2555,26193,479,8807,178,14400,8381,3412
8/11/2020,,,953,16927,6236,2548,26664,471,8784,481,14665,8532,3467
8/12/2020,,,968,17349,6208,2717,27242,578,8925,422,14983,8717,3542
8/13/2020,,,981,17838,6330,2714,27863,621,9044,489,15324,8916,3623
8/14/2020,,,985,18528,6331,2594,28438,575,8925,690,15324,8916,4198
8/15/2020,,,991,18974,6457,2614,29036,598,9071,446,16118,8992,3926
8/16/2020,,,995,19708,6284,2567,29554,518,8851,734,16250,9457,3847
8/17/2020,,,1011,19916,6514,2651,30092,538,9165,208,16551,9630,3911
8/18/2020,,,1028,20505,6602,2462,30597,505,9064,589,16820,9680,4097
8/19/2020,,,1046,21069,6488,2559,31162,565,9047,564,17099,9972,4091
8/20/2020,,,1061,21795,6357,2544,31757,595,8901,726,17300,10102,4355
8/21/2020,,,1076,22228,6518,2576,32398,641,9094,433,17500,10102,4796
8/22/2020,,,1091,22877,6269,2762,32999,601,9031,649,18100,10409,4490
8/23/2020,,,1107,23567,6040,2922,33636,637,8962,690,18399,10633,4604
8/24/2020,,,1112,25463,5090,2630,34295,659,7720,1896,18688,10874,4733
8/25/2020,,,1129,25986,5130,2686,34931,636,7816,523,18788,10913,5230
8/26/2020,,,1144,26750,4978,2770,35642,711,7748,764,19088,11113,5441
8/27/2020,,,1147,28288,4499,2528,36462,820,7027,1538,19308,11313,5841
8/28/2020,,,1154,29169,4128,2827,37278,816,6955,881,20500,11513,5265
8/29/2020,,,1172,29768,4414,2812,38166,888,7226,599,20991,11713,5462
8/30/2020,,,1186,30134,4945,3015,39280,1114,7960,366,21491,11827,5962
8/31/2020,,,1202,30538,5281,3288,40309,1029,8569,404,20500,12027,7782
9/1/2020,,,1219,31267,5423,3341,41250,941,8764,729,20500,12027,8723
9/2/2020,,,1237,31741,5757,3568,42303,1053,9325,474,23553,12327,6423
9/3/2020,,,1253,32424,6323,3709,43709,1406,10032,683,23953,12827,6929
9/4/2020,,,1260,33260,6257,3827,44604,895,10084,836,24507,13027,7070
9/5/2020,,,1277,33991,6501,3677,45446,842,10178,731,25000,14409,6037
9/6/2020,,,1289,34738,6582,4082,46691,1245,10664,747,25600,13941,7150
9/7/2020,,,1318,35431,6706,4341,47796,1105,11047,693,26005,14241,7550
9/8/2020,,,1330,36451,6598,4432,48811,1015,11030,1020,26005,14241,8565
9/9/2020,,,1347,37245,6691,4554,49837,1026,11245,794,27502,14441,7894
9/10/2020,,,1365,38226,6968,4728,51287,1450,11696,981,28502,14841,7944
9/11/2020,,,1382,39115,7143,4681,52321,1034,11824,889,28902,18741,4678
9/12/2020,,,1404,40183,7490,4684,53761,1440,12174,1068,29253,19041,5467
9/13/2020,,,1410,41014,7791,4649,54864,1103,12440,831,29553,19733,5578
9/14/2020,,,1440,42325,7530,4631,55926,1062,12161,1311,6885,1947,3329
9/15/2020,,,1468,43306,7711,4468,56953,1027,12179,981,7058,1947,3174
9/16/2020,,,1498,44251,7907,4802,58458,1505,12709,945,1673,6900,4136
9/17/2020,,,1513,45207,8013,4739,59472,1014,12752,956,6128,1749,4875
9/18/2020,,,1535,46235,8450,4655,60875,1403,13105,1028,6989,2638,3478
9/19/2020,,,1546,47260,8696,4305,61807,932,13001,1025,6296,5873,832
9/20/2020,,,1561,49209,8297,3819,62886,1079,12116,1949,6278,5301,537
9/21/2020,,,1592,49630,9225,3749,64196,1310,12974,421,6278,5301,1395
9/22/2020,,,1624,50473,9380,3841,65318,1122,13221,843,6871,4917,1433
9/23/2020,,,1650,51578,9611,3666,66505,1187,13277,1105,6278,5301,1698
9/24/2020,,,1664,52742,9714,3518,67638,1133,13232,1164,6555,4277,2400
9/25/2020,,,1677,54352,10027,2871,68927,1289,12898,1610,6334,4076,2488
9/26/2020,,,1679,55350,10594,2561,70184,1257,13155,998,7220,3550,2385
9/27/2020,,,1692,56413,10915,2350,71370,1186,13265,1063,6976,3738,2551
9/28/2020,,,1704,57741,10474,2258,72177,807,12732,1328,6678,5701,353
9/29/2020,,,1718,58865,10659,2067,73309,1132,12726,1124,7001,3226,2499
9/30/2020,,,1731,60320,10353,1964,74368,1059,12317,1455,5962,3124,3231
10/1/2020,,,1737,61444,10545,1795,75521,1153,12340,1124,5972,3826,2542
10/2/2020,,,1740,62279,10496,2104,76619,1098,12600,835,5932,3726,2942
10/3/2020,,,1743,63286,10652,2103,77784,1165,12755,1007,5773,3747,3235
10/4/2020,,,1761,64319,11091,2043,79214,1430,13134,1033,6329,3552,3253
10/5/2020,,,1772,65295,10912,2057,80036,822,12969,976,6565,3260,3144
10/6/2020,,,1806,66315,10787,2135,81043,1007,12922,1020,6714,3228,2980
10/7/2020,,,1819,67310,10807,2447,82383,1340,13254,995,6671,3465,3118
10/8/2020,,,1838,68352,10717,2485,83392,1009,13202,1042,7041,3280,2881
10/9/2020,,,1860,69203,10746,2555,84364,972,13301,851,7008,3362,2931
10/10/2020,,,1877,70487,10698,2555,85617,1253,13253,1284,6779,3164,3310
10/11/2020,,,1901,71549,10863,2693,87006,1389,13556,1062,6802,4018,2736
10/12/2020,,,1922,72633,10814,2805,88174,1168,13619,1084,6867,4160,2592
10/13/2020,,,1944,73733,10908,2643,89228,1054,13551,1100,7393,4150,2008
10/14/2020,,,1961,74924,10822,2559,90266,1038,13381,1191,7023,4633,1725
10/15/2020,,,1984,75974,10636,2743,91337,1071,13379,1050,6900,4804,1675
10/16/2020,,,2008,76956,10498,2920,92382,1045,13418,982,6753,5174,1491
10/17/2020,,,2032,78062,10591,2671,93356,974,13262,1106,6376,5611,1275
10/18/2020,,,2051,79136,10782,2358,94327,971,13140,1074,6505,5891,744
10/19/2020,,,2064,80261,10325,2603,95253,926,12928,1125,6185,5755,988
10/20/2020,,,2086,81107,10292,2732,96217,964,13024,846,6557,5747,720
10/21/2020,,,2105,82178,10273,2661,97217,1000,12934,1071,6577,5568,789
10/22/2020,,,2120,83338,9980,2768,98206,989,12748,1160,6530,5475,743
10/23/2020,,,2138,84430,9604,2986,99158,952,12590,1092,6366,5428,796
10/24/2020,,,2153,85586,9557,2924,100220,1062,12481,1156,5974,5541,966
10/25/2020,,,2164,86815,9151,2861,100991,771,12012,1229,6137,5091,784
10/26/2020,,,2185,87977,8960,2775,101897,906,11735,1162,6083,4900,752
10/27/2020,,,2195,89060,8743,2680,102678,781,11423,1083,5947,4834,642
10/28/2020,,,2211,90157,8438,2716,103522,844,11154,1097,5630,4955,569
10/29/2020,,,2225,91235,7951,2824,104235,713,10775,1078,5410,4478,887
10/30/2020,,,2239,92312,7457,2839,104847,612,10296,1077,5410,4478,408
10/31/2020,,,2255,94434,6524,2384,105597,750,8908,2122,4462,4446,0
11/1/2020,,,2273,94819,6935,2178,106205,608,9113,385,4106,4142,865
11/2/2020,,,2291,95876,7312,1750,107229,1024,9062,1057,3987,4258,817
11/3/2020,,,2300,96902,6844,1800,107846,617,8644,1026,3935,4108,601
11/4/2020,,,2315,97833,6665,1807,108620,774,8472,931,3627,4456,389
11/5/2020,,,2331,98806,6260,2014,109411,791,8274,973,3398,4262,614
11/6/2020,,,2348,99830,6050,1855,110083,672,7905,1024,3266,4257,382
11/7/2020,,,2359,100816,6159,1867,111201,1118,8026,986,3049,4205,772
11/8/2020,,,2366,101791,6338,1532,112027,826,7870,975,2640,3833,1397
11/9/2020,,,2377,102844,6050,1472,112743,716,7522,1053,3336,3628,558
11/10/2020,,,2391,104144,5724,1497,113756,1013,7221,1300,3213,3580,428
11/11/2020,,,2403,105117,5161,1662,114343,587,6823,973,2915,3518,390
11/12/2020,,,2414,106189,4878,1693,115174,831,6571,1072,2884,3204,483
11/13/2020,,,2428,107147,5028,1604,116207,1033,6632,958,2821,3193,618
11/14/2020,,,2441,108209,4710,2102,117462,1255,6812,1062,2714,3197,901
11/15/2020,,,2448,109181,4952,2046,118627,1165,6998,972,2556,3659,783
11/16/2020,,,2455,110221,4420,2537,119633,1006,6957,1040,2540,3784,633
11/17/2020,,,2459,111096,4355,2761,120671,1038,7116,875,2652,3732,732
11/18/2020,,,2470,111948,4619,2781,121818,1147,7400,852,2325,3757,1318
11/19/2020,,,2484,112833,4633,3053,123003,1185,7686,885,2788,4099,799
11/20/2020,,,2501,113739,4616,3387,124243,1240,8003,906,3024,4198,781
11/21/2020,,,2515,114863,5323,3121,125822,1579,8444,1124,3160,4255,1029
11/22/2020,,,2531,115939,5529,3165,127164,1342,8694,1076,3322,4550,822
11/23/2020,,,2548,117003,5592,3030,128173,1009,8622,1064,2816,4185,1621
11/24/2020,,,2567,118062,5518,3041,129188,1015,8559,1059,3438,4556,565
11/25/2020,,,2584,119099,6000,2778,130461,1273,8778,1037,3527,4520,731
11/26/2020,,,2597,120287,5876,2765,131525,1064,8641,1188,3710,4292,639
11/27/2020,,,2614,121082,6653,2612,132961,1436,9265,795,3711,4647,907
11/28/2020,,,2632,122328,6921,2450,134331,1370,9371,1246,3938,4524,909
11/29/2020,,,2652,123163,7608,2339,135762,1431,9947,835,3536,4544,1867
11/30/2020,,,2671,124078,7823,2289,136861,1099,10112,915,4307,5027,778
12/1/2020,,,2689,125102,7937,2191,137919,1058,10128,1024,2655,5973,1500
12/2/2020,,,2710,126163,8202,2010,139085,1166,10212,1061,1067,8586,559
12/3/2020,,,2734,127136,8155,2213,140238,1153,10368,973,1542,8082,744
12/4/2020,,,2757,128051,8073,2389,141270,1032,10462,915,2094,7764,604
12/5/2020,,,2779,129067,8623,2161,142630,1360,10784,1016,2622,7195,967
12/6/2020,,,2799,130136,8819,2207,143961,1331,11026,1069,2622,6359,2045
12/7/2020,,,2823,131071,9473,2060,145427,1466,11533,935,4058,6696,779
12/8/2020,,,2842,132248,9650,1861,146601,1174,11511,1177,4550,6276,685
12/9/2020,,,2860,133318,9703,1957,147838,1237,11660,1070,5308,6015,337
12/10/2020,,,2880,134366,9391,2381,149018,1180,11772,1048,4801,5773,1198
12/11/2020,,,2902,135545,9078,2725,150250,1232,11803,1179,5016,5939,848
12/12/2020,,,2922,136489,8822,2968,151201,951,11790,944,5189,5782,819
12/13/2020,,,2941,137605,8679,3274,152499,1298,11953,1116,4585,5653,1715
12/14/2020,,,2963,138988,8994,3120,154065,1566,12114,1383,3776,5697,2641
12/15/2020,,,2990,140225,8643,3264,155122,1057,11907,1237,5008,6217,682
12/16/2020,,,3010,141365,8263,3705,156343,1221,11968,1140,5054,6224,690
12/17/2020,,,3027,142741,7851,4414,158033,1690,12265,1376,5082,5985,1198
12/18/2020,,,3048,143959,7673,4940,159620,1587,12613,1218,4568,5792,2253
12/19/2020,,,3068,145066,8112,5273,161519,1899,13385,1107,5825,6099,1461
12/20/2020,,,3087,146958,8057,5009,163111,1592,13066,1892,6216,5831,1019
12/21/2020,,,3097,148308,8366,4806,164577,1466,13172,1350,6200,6046,926
12/22/2020,,,3115,149691,8620,4462,165888,1311,13082,1383,6119,6078,885
12/23/2020,,,3130,151122,8643,4947,167842,1954,13590,1431,6110,6391,1089
12/24/2020,,,3146,152491,8833,5305,169775,1933,14138,1369,6596,7011,531
12/25/2020,,,3167,154242,8720,5742,171871,2096,14462,1751,6206,6903,1353
12/26/2020,,,3182,156798,9439,4510,173929,2058,13949,2556,5885,6691,1373
12/27/2020,,,3204,158615,9655,4452,175926,1997,14107,1817,4651,6495,2961
12/28/2020,,,3226,159878,9919,4581,177604,1678,14500,1263,4046,6567,3887
12/29/2020,,,3246,161337,10018,5059,179660,2056,15077,1459,6545,7026,1506
12/30/2020,,,3266,162911,9882,5654,181713,2053,15536,1574,7010,7122,1404
12/31/2020,,,3287,164881,9746,5821,183735,2022,15567,1970,6069,6831,2667
1/1/2021,,,3308,166512,10082,5789,185691,1956,15871,1631,7785,6572,1514
1/2/2021,,,3334,168781,10872,4599,187586,1895,15471,2269,8034,6168,1269
1/3/2021,,,3345,170510,10978,4410,189243,1657,15388,1729,8035,6104,1249
1/4/2021,,,3369,173036,10371,4299,191075,1832,14670,2526,7364,6234,1072
1/5/2021,,,3392,174131,10897,4479,192899,1824,15376,1095,6820,6139,2417
1/6/2021,,,3410,175441,12196,4254,195301,2402,16450,1310,8688,7762,0
1/7/2021,,,3435,176882,12781,4601,197699,2398,17382,1441,7848,8006,1528
1/8/2021,,,3463,179562,13397,4236,200658,2959,17633,2680,7272,8628,1733
1/9/2021,,,3485,181613,13076,5237,203411,2753,18313,2051,6781,9628,1904
1/10/2021,,,3517,184576,13166,4863,206122,2711,18029,2963,6284,9914,1831
1/11/2021,,,3551,187086,13541,4405,208583,2461,17946,2510,5180,9246,3520
1/12/2021,,,3589,188675,14591,4397,211252,2669,18988,1589,6861,10618,1509
1/13/2021,,,3634,191635,15009,4450,214728,3476,19459,2960,6757,10186,2516
1/14/2021,,,3675,193719,15852,4647,217893,3165,20499,2084,5878,10055,4566
1/15/2021,,,3710,195924,15553,5247,220434,2541,20800,2205,5182,9366,6252
1/16/2021,,,3745,198136,17524,4565,223970,3536,22089,2212,6820,13159,2110
1/17/2021,,,3779,201907,16741,4938,227365,3395,21679,3771,7281,12302,2096
1/18/2021,,,3815,204711,16419,4781,229726,2361,21200,2804,7379,12474,1347
1/19/2021,,,3836,209238,14604,4611,232289,2563,19215,4527,7929,11280,6
1/20/2021,,,3868,210983,16389,4835,236075,3786,21224,1745,7496,12015,1713
1/21/2021,,,3900,213570,16966,4790,239226,3151,21756,2587,8865,10856,2035
1/22/2021,,,3940,215719,17752,5607,243018,3792,23359,2149,9171,11421,2767
1/23/2021,,,3980,219287,18657,4379,246303,3285,23036,3568,7706,10272,5058
1/24/2021,,,4024,221567,19554,4670,249815,3512,24224,2280,8723,13240,2261
1/25/2021,,,4063,224071,19869,4263,252266,2451,24132,2504,8589,14100,1443
1/26/2021,,,4108,227010,19432,4030,254580,2314,23462,2939,8165,13551,1746
1/27/2021,,,4134,229981,18528,3773,256416,1836,22301,2971,7212,13819,1270
1/28/2021,,,4185,232701,18473,3946,259305,2889,22419,2720,6806,13859,1754
1/29/2021,,,4224,235140,19381,4008,262753,3448,23389,2439,6741,14531,2117
1/30/2021,,,4254,238395,20539,3056,266244,3491,23595,3255,7498,13874,2223
1/31/2021,,,4267,242069,19272,4110,269718,3474,23382,3674,8724,12104,2554
2/1/2021,,,4337,244202,19824,4969,273332,3614,24793,2133,8474,11274,5045
2/2/2021,,,4379,248515,18925,4875,276694,3362,23800,4313,6725,10372,6703
2/3/2021,,,4420,249810,21863,4168,280261,3567,26031,1295,9409,14435,2187
2/4/2021,,,4461,254155,20419,4858,283893,3632,25277,4345,7759,12670,4848
2/5/2021,,,4502,256702,21191,4838,287233,3340,26029,2547,9050,15663,1316
2/6/2021,,,4541,261027,19325,4719,289612,2379,24044,4325,7093,15579,1372
2/7/2021,,,4587,265369,17958,5911,293825,4213,23869,4342,5882,15947,2040
2/8/2021,,,4631,268785,17766,5787,296969,3144,23553,3416,4966,14527,4060
2/9/2021,,,4681,271573,18174,5978,300406,3437,24152,2788,4266,13500,6386
2/10/2021,,,4725,274817,16676,7497,303715,3309,24173,3244,3260,12165,8748
2/11/2021,,,4748,278822,14119,8540,306229,2514,22659,4005,2149,11293,9217
2/12/2021,,,4798,284579,10774,9888,310039,3810,20662,5757,683,8683,11296
2/13/2021,,,4850,289189,9644,9374,313057,3018,19018,4610,672,7586,10760
2/14/2021,,,4895,293538,9017,8103,315553,2496,17120,4349,1587,7605,7928
2/15/2021,,,4940,295623,8881,7988,317432,1879,16869,2085,3876,11955,1038
2/16/2021,,,4987,297695,9042,7569,319293,1861,16611,2072,3419,10799,2393
2/17/2021,,,5026,299795,8467,7450,320738,1445,15917,2100,2770,9442,3705
2/18/2021,,,5044,302451,7067,6549,321111,373,13616,2656,3272,10070,274
2/19/2021,,,5081,304995,7323,5632,323031,1920,12955,2544,2840,8527,1588
2/20/2021,,,5121,307759,7165,5858,325903,2872,13023,2764,2589,8729,1705
2/21/2021,,,5172,310412,7137,5902,328623,2720,13039,2653,1673,7851,3515
2/22/2021,,,5206,312748,7528,5612,331094,2471,13140,2336,1156,6465,5519
2/23/2021,,,5248,314563,7126,4939,331876,782,12065,1815,605,5070,6390
2/24/2021,,,5301,317003,6008,4346,332658,782,10354,2440,75,3217,7062
2/25/2021,,,5346,319326,5499,4068,334239,1581,9567,2323,2476,4621,2470
2/26/2021,,,5385,321038,5560,3917,335900,1661,9477,1712,1684,3764,4029
2/27/2021,,,5439,322285,5885,4028,337637,1737,9913,1247,825,3628,5460
2/28/2021,,,5478,323892,5940,4425,339735,2098,10365,1607,161,3263,6941
3/1/2021,,,5528,326509,5891,3865,341793,2058,9756,2617,2380,6023,1353
3/2/2021,,,5568,328526,5072,3205,342371,578,8277,2017,1581,4543,2153
3/3/2021,,,5613,331016,3742,3437,343808,1437,7179,2490,671,3358,3150
3/4/2021,,,5657,332758,3940,3461,345816,2008,7401,1742,650,2614,4137
3/5/2021,,,5702,334100,4026,3147,346975,1159,7173,1342,376,2138,4659
3/6/2021,,,5748,335617,4228,2998,348591,1616,7226,1517,384,2191,4651
3/7/2021,,,5790,337426,4194,3015,350425,1834,7209,1809,1409,3661,2139
3/8/2021,,,5838,338931,4494,2945,352208,1783,7439,1505,2448,4991,0
3/9/2021,,,5883,340587,3856,2749,353075,867,6605,1656,1892,4186,527
3/10/2021,,,5923,341398,3691,3103,354115,1040,6794,811,1573,3787,1434
3/11/2021,,,5943,342306,4253,3367,355869,1754,7620,908,1577,4749,1294
3/12/2021,,,5969,343351,4670,3752,357742,1873,8422,1045,1186,4729,2507
3/13/2021,,,5991,345202,4226,3357,358776,1034,7583,1851,1670,5243,670
3/14/2021,,,6026,347210,3443,3301,359980,1204,6744,2008,1195,4071,1478
3/15/2021,,,6038,349002,3485,3010,361535,1555,6495,1792,1272,4142,1081
3/16/2021,,,6062,350561,2996,2751,362370,835,5747,1559,832,3301,1614
3/17/2021,,,6077,351680,2907,3036,363700,1330,5943,1119,573,2972,2398
3/18/2021,,,6100,352827,3273,3219,365419,1719,6492,1147,246,2705,3541
3/19/2021,,,6120,354036,3483,3368,367007,1588,6851,1209,1150,4749,952
3/20/2021,,,6143,355221,3894,3686,368944,1937,7580,1185,831,4635,2114
3/21/2021,,,6160,357100,3859,3463,370582,1638,7322,1879,551,3608,3163
3/22/2021,,,6179,358826,3775,3276,372056,1474,7051,1726,1404,4804,843
3/23/2021,,,6206,360479,3107,3079,372871,815,6186,1653,934,3766,1486
3/24/2021,,,6224,362248,2650,2639,373761,890,5289,1769,595,2663,2031
3/25/2021,,,6241,362975,3222,3049,375487,1726,6271,727,536,2664,3071
3/26/2021,,,6260,363599,3629,3380,376868,1381,7009,624,1476,4650,883
3/27/2021,,,6281,364251,3932,3758,378222,1354,7690,652,1269,4639,1782
3/28/2021,,,6304,365592,3966,3830,379692,1470,7796,1341,906,4259,2631
3/29/2021,,,6324,366615,4034,3733,380706,1014,7767,1023,1697,5326,744
3/30/2021,,,6327,367819,3419,3525,381090,384,6944,1204,1250,4576,1118
3/31/2021,,,6341,369007,3028,3679,382055,965,6707,1188,1005,3961,1741
4/1/2021,,,6344,369929,3447,3672,383392,1337,7119,922,705,4175,2239
4/2/2021,,,6351,371254,3433,3594,384632,1240,7027,1325,1069,5153,805
4/3/2021,,,6356,372494,3317,3563,385730,1098,6880,1240,727,4644,1509
4/4/2021,,,6360,373565,3149,3392,386466,736,6541,1071,443,4112,1986
4/5/2021,,,6372,374542,2771,3304,386989,523,6075,977,310,3452,2313
4/6/2021,,,6379,375080,2705,3312,387476,487,6017,538,177,3184,2656
4/7/2021,,,6391,375651,2814,3482,388338,862,6296,571,868,4884,544
4/8/2021,,,6410,376270,3244,3653,389577,1239,6897,619,882,4700,1315
4/9/2021,,,6424,376959,3506,3701,390590,1013,7207,689,2071,4551,585
4/10/2021,,,6435,377797,3716,3619,391567,977,7335,838,1890,4165,1280
4/11/2021,,,6450,379210,3617,3321,392598,1031,6938,1413,939,4107,1892
4/12/2021,,,6459,380560,3324,2947,393290,692,6271,1350,1973,3777,521
4/13/2021,,,6482,381449,3326,2861,394118,828,6187,889,1902,3467,818
4/14/2021,,,6489,382091,3338,2861,394779,661,6199,642,1780,3178,1241
4/15/2021,,,6504,382617,3921,3067,396109,1330,6988,526,5357,745,886
4/16/2021,,,6513,383655,3607,3313,397088,979,6920,1038,1042,4370,1508
4/17/2021,,,6520,384652,3512,3441,398125,1037,6953,997,3509,1306,2138
4/18/2021,,,6536,385615,3313,3611,399075,950,6924,963,305,1481,5138
4/19/2021,,,6558,386606,3218,3666,400048,973,6884,991,2401,3843,640
4/20/2021,,,6569,387507,2945,3487,400508,460,6432,901,1593,3908,931
4/21/2021,,,6587,388083,2954,3486,401110,602,6440,576,1179,3865,1396
4/22/2021,,,6596,388735,3497,3548,402376,1266,7045,652,1136,5043,866
4/23/2021,,,6612,389445,3584,3619,403260,884,7203,710,872,4778,1553
4/24/2021,,,6623,390334,3563,3647,404167,907,7210,889,697,4296,2217
4/25/2021,,,6645,391301,3399,3718,405063,896,7117,967,1329,5213,575
4/26/2021,,,6660,392595,3152,3405,405812,749,6557,1294,1112,4478,967
4/27/2021,,,6679,393205,2999,3322,406205,393,6321,610,1327,4760,234
4/28/2021,,,6690,393814,2950,3390,406844,639,6340,609,1208,4391,741
4/29/2021,,,6710,394403,3308,3410,407831,987,6718,589,1012,4320,1386
4/30/2021,,,6733,394939,3421,3527,408620,789,6948,536,1209,5210,529
5/1/2021,,,6747,395644,3533,3622,409546,926,7155,705,1039,4940,1176
5/2/2021,,,6767,396594,3450,3589,410400,854,7039,950,842,4574,1623
5/3/2021,,,6788,397349,3483,3537,411157,757,7020,755,1349,5473,198
5/4/2021,,,6807,397955,3247,3564,411573,416,6811,606,1182,5158,471
5/5/2021,,,6830,398610,3240,3738,412418,845,6978,655,1102,4909,967
5/6/2021,,,6850,399224,3406,3843,413323,905,7249,614,1172,5489,588
5/7/2021,,,6872,399821,3485,3928,414106,783,7413,597,1131,5192,1090
5/8/2021,,,6896,400403,3569,3970,414838,732,7539,582,947,5022,1570
5/9/2021,,,6911,401114,3648,3974,415647,809,7622,711,836,4763,2023
5/10/2021,,,6933,401744,3723,3941,416341,694,7664,630,1482,5810,372
5/11/2021,,,6952,402374,3490,3931,416747,406,7421,630,1340,5531,550
5/12/2021,,,6973,403039,3402,3989,417403,656,7391,665,1176,5298,917
5/13/2021,,,6973,403630,3630,3955,418188,785,7585,591,1087,5013,1485
5/14/2021,,,7003,404187,3502,4128,418820,632,7630,557,1294,5929,407
5/15/2021,,,7066,404715,3288,3978,419047,227,7266,528,6055,637,574
5/16/2021,,,7082,404980,3189,3957,419208,161,7146,265,1145,5333,668
5/17/2021,,,7107,405229,3158,4135,419629,421,7293,249,1235,5834,224
5/18/2021,,,7130,405357,3248,4185,419920,291,7433,128,1219,5793,421
5/19/2021,,,7149,405535,3366,4409,420459,539,7775,178,1195,5818,762
5/20/2021,,,7169,405714,3797,4674,421354,895,8471,179,1312,6599,560
5/21/2021,,,7184,405918,4142,4966,422210,856,9108,204,1306,6655,1147
5/22/2021,,,7196,406300,4386,5260,423142,932,9646,382,1556,7514,576
5/23/2021,,,7207,406669,4744,5389,424009,867,10133,369,1479,7469,1185
5/24/2021,,,7225,406987,5079,5537,424828,819,10616,318,1837,8217,562
5/25/2021,,,7239,407493,5017,5463,425212,384,10480,506,1737,7878,865
5/26/2021,,,7250,408019,4993,5567,425829,617,10560,526,1619,7619,1322
5/27/2021,,,7271,408585,5280,5633,426769,940,10913,566,1937,8364,612
5/28/2021,,,7288,409497,5161,5516,427462,693,10677,912,1658,7859,1160
5/29/2021,,,7296,410508,5004,5461,428269,807,10465,1011,1557,7184,1724
5/30/2021,,,7309,411495,5100,5429,429333,1064,10529,987,1375,6661,2493
5/31/2021,,,7327,412074,5241,5417,430059,726,10658,579,2117,8023,518
6/1/2021,,,7349,412593,5214,5422,430578,519,10636,519,1996,7706,934
6/2/2021,,,7361,413179,5178,5461,431179,601,10639,586,1951,7330,1358
6/3/2021,,,7381,413680,5402,5430,431893,714,10832,501,1811,7116,1905
6/4/2021,,,7402,414496,5414,5487,432799,906,10901,816,2618,7650,633
6/5/2021,,,7423,415317,5756,5620,434116,1317,11376,821,2404,7279,1693
6/6/2021,,,7438,416181,5966,5550,435135,1019,11516,864,1901,7135,2480
6/7/2021,,,7457,416994,6261,5620,436332,1197,11881,813,2412,8576,893
6/8/2021,,,7478,417997,6057,5555,437087,755,11612,1003,2186,7949,1477
6/9/2021,,,7499,419109,6120,5730,438458,1371,11850,1112,1992,7270,2588
6/10/2021,,,7523,420211,6991,5829,440554,2096,12820,1102,1789,6881,4150
6/11/2021,,,7543,421396,7750,6158,442847,2293,13908,1185,1456,6442,6010
6/12/2021,,,7557,422121,8855,6769,445302,2455,15624,725,1289,6395,7940
6/13/2021,,,7571,423056,10034,7410,448071,2769,17444,935,1117,6352,9975
6/14/2021,,,7609,424088,11240,7856,450793,2722,19096,1032,4032,13945,1119
6/15/2021,,,7634,425417,11102,8142,452295,1502,19244,1329,3746,13108,2390
6/16/2021,,,7665,426695,11555,8756,454671,2376,20311,1278,3458,12419,4434
6/17/2021,,,7713,428764,13054,9284,458815,4144,22338,2069,2882,11788,7668
6/18/2021,,,7777,431264,14951,9560,463552,4737,24511,2500,2531,10655,11325
6/19/2021,,,7836,433499,16787,10325,468447,4895,27112,2235,1840,9740,15532
6/20/2021,,,7905,435982,19105,11037,474029,5582,30142,2483,1325,8734,20083
6/21/2021,,,7976,439007,20717,11343,479043,5014,32060,3025,8039,19670,4351
6/22/2021,,,8014,442059,21167,11024,482264,3221,32191,3052,6351,16241,9599
6/23/2021,,,8057,443195,22868,12837,486957,4693,35705,1136,6163,15906,13636
6/24/2021,,,8107,445718,26403,14234,494462,7505,40637,2523,5567,15624,19446
6/25/2021,,,8177,448288,29325,15606,501396,6934,44931,2570,5170,14668,25093
6/26/2021,,,8220,451013,33829,17605,510667,9271,51434,2725,4381,14547,32506
6/27/2021,,,8269,454497,38464,18831,520061,9394,57295,3484,3484,13789,40022
6/28/2021,,,8348,457935,42252,19874,528409,8348,62126,3438,17144,29461,15521
6/29/2021,,,8426,461439,45504,20419,535788,7379,65923,3504,15706,28925,21292
6/30/2021,,,8486,464943,47829,22210,543468,7680,70039,3504,14940,27514,27585
7/1/2021,,,8528,468461,49836,24184,551009,7541,74020,3518,13902,26151,33967
7/2/2021,,,8547,473467,53014,25380,560408,9399,78394,5006,12103,25076,41215
7/3/2021,,,8577,479150,54941,27442,570110,9702,82383,5683,11310,21941,49132
7/4/2021,,,8652,484949,59307,27687,580595,10485,86994,5799,8799,20101,58094
7/5/2021,,,8779,491556,62873,28290,591498,10903,91163,6607,7598,20096,63469
7/6/2021,,,8861,497492,65448,29136,600937,9439,94584,5936,18451,60476,15657
7/7/2021,,,9042,501199,69644,30418,610303,9366,100062,3707,18376,57521,24165
7/8/2021,,,9110,512085,72361,29721,623277,12974,102082,10886,14748,50824,36510
7/9/2021,,,9306,526941,73239,26903,636389,13112,100142,14856,10095,40727,49320
7/10/2021,,,9357,543867,71812,24273,649309,12920,96085,16926,7999,26379,61707
7/11/2021,,,9395,564437,68251,20359,662442,13133,88610,20570,4769,12893,70948
7/12/2021,,,9462,584912,66581,16106,677061,14619,82687,20475,17649,25597,39441
7/13/2021,,,9541,589486,71848,18368,689243,12182,90216,4574,16957,22339,50920
7/14/2021,,,9603,592556,78571,21180,701910,12667,99751,3070,32752,54463,12536
7/15/2021,,,9743,595582,86298,22978,714601,12691,109276,3026,31922,52360,24994
7/16/2021,,,9845,604033,88295,24843,727016,12415,113138,8451,28216,48144,36778
7/17/2021,,,9902,615640,87929,23713,737184,10168,111642,11607,23349,41735,46558
7/18/2021,,,10103,627481,86457,22271,746312,9128,108728,11841,20890,33459,54379
7/19/2021,,,10345,640171,81275,19521,751312,5000,100796,12690,35311,51962,13523
7/20/2021,,,10610,652242,75776,18897,757525,6213,94673,12071,30983,44129,19561
7/21/2021,,,10692,662800,72115,17822,763429,5904,89937,10558,27122,38320,24495
7/22/2021,,,10865,673424,68974,17224,770487,7058,86198,10624,22418,32730,31050
7/23/2021,,,11021,687864,62789,16846,778520,8033,79635,14440,18931,24456,36248
7/24/2021,,,11181,702477,56946,16276,786880,8360,73222,14613,16072,13489,43661
7/25/2021,,,11333,716838,48934,15168,792273,5393,64102,14361,18044,32952,13106
7/26/2021,,,11436,731504,38271,13724,794935,2662,51995,14666,10463,28033,13499
7/27/2021,,,11606,746087,26961,13848,798502,3567,40809,14583,8911,21290,10608
7/28/2021,,,11688,757122,22332,12885,804027,5525,35217,11035,5114,14320,15783
7/29/2021,,,11844,768562,16676,10790,807872,3845,27466,11440,1630,7060,18776
7/30/2021,,,11952,779720,11264,8390,811326,3454,19654,11158,2798,11212,5644
7/31/2021,,,12135,784668,10134,7716,814653,3327,17850,4948,1784,7157,8909
8/1/2021,,,12209,789261,9399,6485,817354,2701,15884,4593,115,4275,11494
8/2/2021,,,12363,791422,9202,5777,818764,1410,14979,2161,27,2468,12484
8/3/2021,,,12433,793928,8705,5299,820365,1601,14004,2506,27,1389,12588
8/4/2021,,,12514,796381,9535,4916,823346,2981,14451,2453,27,308,14116
8/5/2021,,,12629,799151,9458,4419,825657,2311,13877,2770,0,0,13877
8/6/2021,,,12682,802373,8813,3974,827842,2185,12787,3222,0,0,12787
8/7/2021,,,12750,806924,6957,3219,829850,2008,10176,4551,0,0,10176
8/8/2021,,,12770,808087,7567,3075,831499,1649,10642,1163,0,0,10642
8/9/2021,,,12783,809087,7430,2926,832226,727,10356,1000,0,0,10356
8/10/2021,,,12824,810308,7495,3024,833651,1425,10519,1221,0,0,10519
8/11/2021,,,12866,811642,7873,3228,835609,1958,11101,1334,0,0,11101
8/12/2021,,,12908,813898,7008,2873,836687,1078,9881,2256,0,0,9881
8/13/2021,,,12976,815468,6724,2729,837897,1210,9453,1570,0,0,9453
8/14/2021,,,13005,816687,6748,2820,839260,1363,9568,1219,0,0,9568
8/15/2021,,,13022,817764,6755,2901,840442,1182,9656,1077,0,0,9656
8/16/2021,,,13050,818700,6290,2915,840955,513,9205,936,0,0,9205
8/17/2021,,,13074,819620,5955,2961,841610,655,8916,920,0,0,8916
8/18/2021,,,13087,820517,6006,3029,842639,1029,9035,897,0,0,9035
8/19/2021,,,13121,821451,5794,3004,843370,731,8798,934,0,0,8798
8/20/2021,,,13132,822399,5721,3087,844339,969,8808,948,0,0,8808
8/21/2021,,,13152,823314,5565,3199,845230,891,8764,915,0,0,8764
8/22/2021,,,13173,824227,5584,2947,845931,701,8531,913,0,0,8531
8/23/2021,,,13193,824958,5477,2788,846416,485,8265,731,0,0,8265
8/24/2021,,,13203,825573,5277,2847,846900,484,8124,615,0,0,8124
8/25/2021,,,13214,826302,5442,2731,847689,789,8173,729,0,0,8173
8/26/2021,,,13216,827333,5110,2604,848263,574,7714,1031,0,0,7714
8/27/2021,,,13232,827674,5491,2504,848901,638,7995,341,0,0,7995
8/28/2021,,,13242,828125,5607,2395,849369,468,8002,451,0,0,8002
8/29/2021,,,13252,828838,5497,2256,849843,474,7753,713,0,0,7753
8/30/2021,,,13261,829668,5097,2158,850184,341,7255,830,0,0,7255
8/31/2021,,,13290,830197,4980,2116,850583,399,7096,529,0,0,7096
9/1/2021,,,13302,831293,4489,2172,851256,673,6661,1096,0,0,6661
9/2/2021,,,13312,832130,4201,2043,851686,430,6244,837,0,0,6244
9/3/2021,,,13322,832952,3841,1914,852029,343,5755,822,0,0,5755
9/4/2021,,,13332,833437,3807,1813,852389,360,5620,485,0,0,5620
9/5/2021,,,13342,833765,3820,1765,852692,303,5585,328,0,0,5585
9/6/2021,,,13359,834489,3417,1644,852909,217,5061,724,0,0,5061
9/7/2021,,,13372,835030,3172,1597,853171,262,4769,541,0,0,4769
9/8/2021,,,13386,835700,2977,1536,853599,428,4513,670,0,0,4513
9/9/2021,,,13399,836187,2843,1478,853907,308,4321,487,0,0,4321
9/10/2021,,,13411,836644,2659,1454,854168,261,4113,457,0,0,4113
9/11/2021,,,13431,837033,2554,1418,854436,268,3972,389,0,1,3971
9/12/2021,,,13437,837364,2539,1402,854742,306,3941,331,0,1,3940
9/13/2021,,,13443,837805,2454,1227,854929,187,3681,441,0,0,3681
9/14/2021,,,13445,838306,2268,1100,855119,190,3368,501,0,0,3368
9/15/2021,,,13455,838680,2223,1066,855424,305,3289,374,0,0,3289
9/16/2021,,,13464,839022,2092,1022,855600,176,3114,342,0,0,3114
9/17/2021,,,13469,839379,1958,1000,855806,206,2958,357,0,0,2958
9/18/2021,,,13475,839623,1934,974,856006,200,2908,244,0,0,2908
9/19/2021,,,13479,839803,1916,963,856161,155,2879,180,653,2226,0
9/20/2021,,,13482,840212,1694,864,856252,91,2558,409,0,0,2558
9/21/2021,,,13486,840525,1552,795,856358,106,2347,313,0,0,2347
9/22/2021,,,13490,840812,1509,774,856585,227,2283,287,373,1530,380
9/23/2021,,,13493,841065,1505,687,856750,165,2192,253,367,1663,162
9/24/2021,,,13497,841393,1409,632,856931,181,2041,328,402,1639,0
9/25/2021,,,13500,841592,1381,591,857064,133,1972,199,400,1441,131
9/26/2021,,,13503,841719,1403,607,857232,168,2010,127,397,1314,299
9/27/2021,,,13507,841980,1296,552,857335,103,1848,261,327,1137,384
9/28/2021,,,13512,842141,1246,540,857439,104,1786,161,292,996,498
9/29/2021,,,13516,842336,1230,534,857616,177,1764,195,245,844,675
9/30/2021,,,13519,842541,1195,510,857765,149,1705,205,201,696,808
10/1/2021,,,13524,842715,1173,504,857916,151,1677,174,377,1151,149
10/2/2021,,,13529,842842,1217,483,858071,155,1700,127,375,1033,292
10/3/2021,,,13534,842929,1235,500,858198,127,1735,87,365,950,420
10/4/2021,,,13534,843091,1261,461,858347,149,1722,162,820,323,579
10/5/2021,,,13538,843239,1198,444,858419,72,1642,148,282,711,649
10/6/2021,,,13540,843414,1217,451,858622,203,1668,175,225,602,841
10/7/2021,,,13541,843529,1253,448,858771,149,1701,115,181,530,990
10/8/2021,,,13541,843738,1206,436,858921,150,1642,209,97,405,1140
10/9/2021,,,13543,843822,1229,427,859021,100,1656,84,94,326,1236
10/10/2021,,,13547,843891,1285,438,859161,140,1723,69,94,264,1365
10/11/2021,,,13549,844189,1078,386,859202,41,1464,298,0,52,1412
10/12/2021,,,13550,844538,947,310,859345,143,1257,349,0,0,1257
10/13/2021,,,13550,844742,972,359,859623,278,1331,204,0,0,1331
10/14/2021,,,13550,844839,978,369,859736,113,1347,97,0,0,1347
10/15/2021,,,13550,844901,1030,379,859860,124,1409,62,0,0,1409
10/16/2021,,,13551,845121,992,350,860014,154,1342,220,0,0,1342
10/17/2021,,,13551,845248,998,348,860145,131,1346,127,0,0,1346
10/18/2021,,,13552,845386,984,330,860252,107,1314,138,0,0,1314
10/19/2021,,,13552,845508,967,331,860358,106,1298,122,0,0,1298
10/20/2021,,,13552,845650,947,312,860461,103,1259,142,0,0,1259
10/21/2021,,,13553,845763,934,300,860550,89,1234,113,0,0,1234
10/22/2021,,,13553,845884,895,301,860633,83,1196,121,0,0,1196
10/23/2021,,,13555,846056,846,292,860749,116,1138,172,0,0,1138
10/24/2021,,,13556,846185,852,287,860880,131,1139,129,0,0,1139
10/25/2021,,,13557,846352,774,279,860962,82,1053,167,0,0,1053
10/26/2021,,,13558,846525,660,256,860999,37,916,173,0,0,916
10/27/2021,,,13559,846667,618,260,861104,105,878,142,0,0,878
10/28/2021,,,13560,846749,670,256,861235,131,926,82,0,0,926
10/29/2021,,,13560,846799,713,259,861331,96,972,50,0,0,972
10/30/2021,,,13561,846942,660,264,861427,96,924,143,0,0,924
10/31/2021,,,13562,847021,686,271,861540,113,957,79,0,0,957
11/1/2021,,,13562,847066,722,273,861623,83,995,45,0,0,995
11/2/2021,,,13562,847201,671,266,861700,77,937,135,0,0,937
11/3/2021,,,13563,847353,658,258,861832,132,916,152,0,0,916
11/4/2021,,,13564,847403,718,258,861943,111,976,50,0,0,976
11/5/2021,,,13565,847438,802,256,862061,118,1058,35,0,0,1058
11/6/2021,,,13566,847685,648,231,862130,69,879,247,0,0,879
11/7/2021,,,13566,847808,653,220,862247,117,873,123,0,0,873
11/8/2021,,,13566,847885,627,198,862276,29,825,77,0,0,825
11/9/2021,,,13566,848034,577,193,862370,94,770,149,0,0,770
11/10/2021,,,13566,848093,608,198,862465,95,806,59,0,0,806
11/11/2021,,,13567,848137,660,208,862572,107,868,44,0,0,868
11/12/2021,,,13567,848311,578,187,862643,71,765,174,0,0,765
11/13/2021,,,13567,848419,534,177,862697,54,711,108,0,0,711
11/14/2021,,,13568,848527,514,180,862789,92,694,108,0,0,694
11/15/2021,,,13569,848604,477,175,862825,36,652,77,0,0,652
11/16/2021,,,13569,848710,447,178,862904,79,625,106,0,0,625
11/17/2021,,,13570,848871,397,196,863034,130,593,161,0,0,593
11/18/2021,,,13571,849007,344,212,863134,100,556,136,0,0,556
11/19/2021,,,13573,849111,348,199,863231,97,547,104,0,0,547
11/20/2021,,,13574,849265,297,209,863345,114,506,154,0,0,506
11/21/2021,,,13574,849386,296,200,863456,111,496,121,9,3,484
11/22/2021,,,13574,849448,278,182,863482,26,460,62,9,3,448
11/23/2021,,,13574,849491,303,183,863551,69,486,43,9,3,474
11/24/2021,,,13575,849596,294,168,863633,82,462,105,0,0,462
11/25/2021,,,13576,849638,274,199,863687,54,473,42,19,23,431
11/26/2021,,,13576,849693,292,196,863757,70,488,55,22,19,447
11/27/2021,,,13576,849779,252,204,863811,54,456,86,19,22,415
11/28/2021,,,13576,849831,272,183,863862,51,455,52,18,16,421
11/29/2021,,,13576,849902,255,170,863903,41,425,71,16,11,398
11/30/2021,,,13576,849929,264,178,863947,44,442,27,16,9,417
12/1/2021,,,13576,849979,282,180,864017,70,462,50,0,1,461
12/2/2021,,,13576,850046,248,175,864045,28,423,67,0,0,423
12/3/2021,,,13577,850114,229,167,864087,42,396,68,0,0,396
12/4/2021,,,13578,850175,209,173,864135,48,382,61,10,5,367
12/5/2021,,,13579,850228,210,161,864178,43,371,53,8,11,352
12/6/2021,,,13581,850281,181,149,864192,14,330,53,9,21,300
12/7/2021,,,13582,850319,171,151,864223,31,322,38,16,26,280
12/8/2021,,,13583,850364,170,147,864264,41,317,45,32,17,268
12/9/2021,,,13583,850439,153,125,864300,36,278,75,21,38,219
12/10/2021,,,13583,850475,144,124,864326,26,268,36,42,31,195
12/11/2021,,,13583,850517,132,126,864358,32,258,42,33,29,196
12/12/2021,,,13583,850557,128,122,864390,32,250,40,27,21,202
12/13/2021,,,13583,850595,111,117,864406,16,228,38,30,28,170
12/14/2021,,,13583,850621,103,119,864426,20,222,26,27,75,120
12/15/2021,,,13583,850649,104,113,864449,23,217,28,25,79,113
12/16/2021,,,13583,850685,108,113,864489,40,221,36,26,70,125
12/17/2021,,,13583,850719,118,107,864527,38,225,34,28,66,131
12/18/2021,,,13583,850751,136,131,864601,74,267,32,62,24,181
12/19/2021,,,13583,850797,140,124,864644,43,264,46,39,21,204
12/20/2021,,,13584,850817,150,131,864682,38,281,20,19,38,224
12/21/2021,,,13584,850837,160,156,864737,55,316,20,33,50,233
12/22/2021,,,13584,850858,176,162,864780,43,338,21,68,36,234
12/23/2021,,,13584,850910,157,145,864796,16,302,52,50,32,220
12/24/2021,,,13584,850939,168,174,864865,69,342,29,78,35,229
12/25/2021,,,13584,850984,170,207,864945,80,377,45,28,71,278
12/26/2021,,,13584,851008,176,224,864992,47,400,24,28,63,309
12/27/2021,,,13584,851096,171,183,865034,42,354,88,22,24,308
12/28/2021,,,13585,851138,236,171,865130,96,407,42,21,22,364
12/29/2021,,,13587,851167,238,165,865157,27,403,29,35,35,333
12/30/2021,,,13587,851201,251,171,865210,53,422,34,34,36,352
12/31/2021,,,13588,851222,295,192,865297,87,487,21,36,35,416
1/1/2022,,,13588,851280,342,205,865415,118,547,58,33,33,481
1/2/2022,,,13588,851386,428,116,865518,103,544,106,32,22,490
1/3/2022,,,13588,851408,554,140,865690,172,694,22,33,39,622
1/4/2022,,,13588,851449,627,141,865805,115,768,41,55,42,671
1/5/2022,,,13589,851520,787,168,866064,259,955,71,50,63,842
1/6/2022,,,13589,851572,956,214,866331,267,1170,52,59,41,1070
1/7/2022,,,13589,851648,1173,221,866631,300,1394,76,62,35,1297
1/8/2022,,,13589,851727,1336,257,866909,278,1593,79,88,64,1441
1/9/2022,,,13589,851839,1575,299,867302,393,1874,112,84,68,1722
1/10/2022,,,13589,851944,1807,322,867662,360,2129,105,85,81,1963
1/11/2022,,,13590,852126,2081,402,868199,537,2483,182,75,78,2330
1/12/2022,,,13590,852269,2246,506,868611,412,2752,143,78,96,2578
1/13/2022,,,13590,852563,2353,583,869089,478,2936,294,78,104,2754
1/14/2022,,,13591,852727,2656,669,869643,554,3325,164,92,108,3125
1/15/2022,,,13591,853003,3011,758,870363,720,3769,276,117,86,3566
1/16/2022,,,13591,853522,3045,771,870929,566,3816,519,73,131,3612
1/17/2022,,,13591,853987,3035,809,871422,493,3844,465,58,121,3665
1/18/2022,,,13591,854204,3316,981,872092,670,4297,217,131,74,4092
1/19/2022,,,13591,854589,3799,1125,873104,1012,4924,385,149,84,4691
1/20/2022,,,13591,855026,4420,1222,874259,1155,5642,437,168,86,5388
1/21/2022,,,13591,855676,5031,1445,875743,1484,6476,650,195,96,6185
1/22/2022,,,13591,856137,6130,1710,877568,1825,7840,461,86,216,7538
1/23/2022,,,13597,856653,7046,2011,879307,1739,9057,516,243,79,8735
1/24/2022,,,13597,857215,8246,2242,881300,1993,10488,562,272,101,10115
1/25/2022,,,13606,857688,9475,2721,883490,2190,12196,473,105,281,11810
1/26/2022,,,13612,859305,10850,3232,886999,3509,14082,1617,244,81,13757
1/27/2022,,,13615,861203,12341,3989,891148,4149,16330,1898,56,269,16005
1/28/2022,,,13617,862670,14710,4709,895706,4558,19419,1467,57,237,19125
1/29/2022,,,13627,864447,17852,5545,901471,5765,23397,1777,47,206,23144
1/30/2022,,,13639,866477,21629,6348,908093,6622,27977,2030,49,174,27754
1/31/2022,,,13666,867519,25361,6809,913355,5262,32170,1042,44,153,31973
2/1/2022,,,13678,869184,28863,8018,919743,6388,36881,1665,131,44,36706
2/2/2022,,,13689,873212,33384,8590,928875,9132,41974,4028,98,27,41849
2/3/2022,,,13713,877579,38248,9652,939192,10317,47900,4367,22,173,47705
2/4/2022,,,13738,883377,43722,11534,952371,13179,55256,5798,17,137,55102
2/5/2022,,,13767,891571,46609,13198,965145,12774,59807,8194,115,17,59675
2/6/2022,,,13794,899957,52594,14625,980970,15825,67219,8386,45,6,67168
2/7/2022,,,13832,905285,59023,15512,993652,12682,74535,5328,44,49,74442
2/8/2022,,,13872,910435,62941,17221,1004469,10817,80162,5150,29,24,80109
2/9/2022,,,13889,923652,63131,18150,1018822,14353,81281,13217,5,6,81270
2/10/2022,,,13911,929100,67456,19445,1029912,11090,86901,5448,10,4,86887
2/11/2022,,,13950,945079,61665,19925,1040619,10707,81590,15979,9,1,81580
2/12/2022,,,13989,960624,59225,19198,1053036,12417,78423,15545,12,2,78409
2/13/2022,,,14032,975674,54602,18900,1063208,10172,73502,15050,4,18,73480
2/14/2022,,,14085,975770,62755,20873,1073483,10275,83628,96,17,6,83605
2/15/2022,,,14135,984861,63221,20748,1082965,9482,83969,9091,24,36,83909
2/16/2022,,,14191,992213,67232,21717,1095353,12388,88949,7352,46,30,88873
2/17/2022,,,14255,1008870,60632,20132,1103889,8536,80764,16657,29,33,80702
2/18/2022,,,14301,1020564,68649,8564,1112078,8189,77213,11694,21,14,77178
2/19/2022,,,14326,1031739,67464,8002,1121531,9453,75466,11175,8,20,75438
2/20/2022,,,14358,1043718,63658,7933,1129667,8136,71591,11979,15,5,71571
2/21/2022,,,14382,1055584,57957,7102,1135025,5358,65059,11866,5,5,65049
2/22/2022,,,14415,1064272,54492,7054,1140233,5208,61546,8688,5,5,61536
2/23/2022,,,14466,1071054,55116,6892,1147528,7295,62008,6782,12,5,61991
2/24/2022,,,14513,1082827,50250,6793,1154383,6855,57043,11773,22,4,57017
2/25/2022,,,14555,1091226,46586,6540,1158907,4524,53126,8399,4,23,53099
2/26/2022,,,14585,1100117,42956,5924,1163582,4675,48880,8891,22,2,48856
2/27/2022,,,14609,1109056,38294,5580,1167539,3957,43874,8939,2,20,43852
2/28/2022,,,14664,1120433,34301,5441,1174839,7300,39742,11377,0,10,39732
3/1/2022,,,14690,1126008,32698,5077,1178473,3634,37775,5575,25,2,37748
3/2/2022,,,14710,1129828,33246,4885,1182669,4196,38131,3820,22,4,38105
3/3/2022,,,14730,1137499,30582,4527,1187338,4669,35109,7671,24,2,35083
3/4/2022,,,14754,1143134,28620,4557,1191065,3727,33177,5635,1,28,33148
3/5/2022,,,14779,1148415,26276,4654,1194124,3059,30930,5281,1,24,30905
3/6/2022,,,14798,1152865,25515,4615,1197793,3669,30130,4450,1,24,30105
3/7/2022,,,14828,1156926,23985,4747,1200486,2693,28732,4061,0,18,28714
3/8/2022,,,14852,1161139,23353,4711,1204055,3569,28064,4213,0,17,28047
3/9/2022,,,14863,1164852,23627,4585,1207927,3872,28212,3713,0,12,28200
3/10/2022,,,14881,1168549,23480,4563,1211473,3546,28043,3697,0,21,28022
3/11/2022,,,14896,1173761,21240,4124,1214021,2548,25364,5212,0,16,25348
3/12/2022,,,14921,1178124,19285,3796,1216126,2105,23081,4363,0,24,23057
3/13/2022,,,14955,1180576,18707,3762,1218000,1874,22469,2452,0,20,22449
3/14/2022,,,14988,1184667,16373,3279,1219307,1307,19652,4091,0,11,19641
3/15/2022,,,15019,1187307,15603,2949,1220878,1571,18552,2640,0,15,18537
3/16/2022,,,15031,1189556,15095,2902,1222584,1706,17997,2249,0,16,17981
3/17/2022,,,15043,1193225,13384,2515,1224167,1583,15899,3669,0,20,15879
3/18/2022,,,15061,1196098,12052,2472,1225683,1516,14524,2873,0,21,14503
3/19/2022,,,15073,1198669,11111,2315,1227168,1485,13426,2571,0,21,13405
3/20/2022,,,15087,1200920,10004,2324,1228335,1167,12328,2251,0,20,12308
3/21/2022,,,15093,1202740,9084,2280,1229197,862,11364,1820,0,17,11347
3/22/2022,,,15102,1204167,8773,2167,1230209,1012,10940,1427,2,19,10919
3/23/2022,,,15106,1205353,8903,2082,1231444,1235,10985,1186,2,25,10958
3/24/2022,,,15111,1207258,8098,2044,1232511,1067,10142,1905,7,42,10093
3/25/2022,,,15116,1208909,7445,1931,1233401,890,9376,1651,8,47,9321
3/26/2022,,,15121,1210332,6938,1806,1234197,796,8744,1423,17,46,8681
3/27/2022,,,15126,1211717,6186,1762,1234791,594,7948,1385,18,56,7874
3/28/2022,,,15138,1213009,5653,1564,1235364,573,7217,1292,16,73,7128
3/29/2022,,,15148,1213901,5744,1313,1236106,742,7057,892,14,61,6982
3/30/2022,,,15159,1214728,5907,1213,1237007,901,7120,827,10,96,7014
3/31/2022,,,15167,1216040,5437,1092,1237736,729,6529,1312,6,68,6455
4/1/2022,,,15175,1217108,5119,975,1238377,641,6094,1068,16,78,6000
4/2/2022,,,15183,1218121,4795,911,1239010,633,5706,1013,12,49,5645
4/3/2022,,,15190,1218930,4636,866,1239622,612,5502,809,7,41,5454
4/4/2022,,,15200,1219664,4436,810,1240110,488,5246,734,5,34,5207
4/5/2022,,,15205,1220235,4420,818,1240678,568,5238,571,4,54,5180
4/6/2022,,,15207,1220769,4714,741,1241431,753,5455,534,2,67,5386
4/7/2022,,,15212,1221596,4609,688,1242105,674,5297,827,12,73,5212
4/8/2022,,,15214,1222380,4456,647,1242697,592,5103,784,12,65,5026
4/9/2022,,,15217,1223059,4267,604,1243147,450,4871,679,8,48,4815
4/10/2022,,,15220,1223655,4039,603,1243517,370,4642,596,4,47,4591
4/11/2022,,,15224,1224308,3755,542,1243829,312,4297,653,2,93,4202
4/12/2022,,,15229,1224805,3607,543,1244184,355,4150,497,6,93,4051
4/13/2022,,,15232,1225348,3515,488,1244583,399,4003,543,16,109,3878
4/14/2022,,,15234,1226139,3127,455,1244955,372,3582,791,34,78,3470
4/15/2022,,,15238,1226739,2837,451,1245265,310,3288,600,27,59,3202
4/16/2022,,,15240,1227338,2469,411,1245458,193,2880,599,23,35,2822
4/17/2022,,,15244,1227793,2205,411,1245653,195,2616,455,17,25,2574
4/18/2022,,,15250,1228205,1997,371,1245823,170,2368,412,19,48,2301
4/19/2022,,,15252,1228519,1876,355,1246002,179,2231,314,20,46,2165
4/20/2022,,,15254,1228783,1866,330,1246233,231,2196,264,18,46,2132
4/21/2022,,,15258,1229206,1603,325,1246392,159,1928,423,18,44,1866
4/22/2022,,,15261,1229616,1417,313,1246607,215,1730,410,10,31,1689
4/23/2022,,,15264,1229971,1256,288,1246779,172,1544,355,10,21,1513
4/24/2022,,,15265,1230220,1149,280,1246914,135,1429,249,7,17,1405
4/25/2022,,,15266,1230368,1107,274,1247015,101,1381,148,9,29,1343
4/26/2022,,,15268,1230600,1077,269,1247214,199,1346,232,13,30,1303
4/27/2022,,,15271,1230742,1053,278,1247344,130,1331,142,12,37,1282
4/28/2022,,,15272,1230989,951,245,1247457,113,1196,247,8,30,1158
4/29/2022,,,15273,1231171,923,216,1247583,126,1139,182,4,25,1110
4/30/2022,,,15274,1231413,829,218,1247734,151,1047,242,3,20,1024
5/1/2022,,,15275,1231573,756,211,1247815,81,967,160,2,19,946
5/2/2022,,,15277,1231709,708,209,1247903,88,917,136,1,12,904
5/3/2022,,,15278,1231833,623,209,1247943,40,832,124,0,8,824
5/4/2022,,,15280,1231950,587,188,1248005,62,775,117,0,6,769
5/5/2022,,,15281,1232106,510,194,1248091,86,704,156,0,1,703
5/6/2022,,,15282,1232228,476,194,1248180,89,670,122,0,0,670
5/7/2022,,,15283,1232328,438,193,1248242,62,631,100,1,2,628
5/8/2022,,,15284,1232444,408,184,1248320,78,592,116,0,2,590
5/9/2022,,,15285,1232527,419,191,1248422,102,610,83,0,5,605
5/10/2022,,,15287,1232618,490,177,1248572,150,667,91,1,8,658
5/11/2022,,,15288,1232696,549,168,1248701,129,717,78,1,13,703
5/12/2022,,,15290,1232729,614,168,1248801,100,782,33,2,11,769
5/13/2022,,,15291,1232772,664,175,1248902,101,839,43,4,12,823
5/14/2022,,,15292,1232867,676,181,1249016,114,857,95,4,14,839
5/15/2022,,,15293,1232939,686,191,1249109,93,877,72,2,8,867
5/16/2022,,,15293,1233010,701,175,1249179,70,876,71,2,8,866
5/17/2022,,,15293,1233102,670,189,1249254,75,859,92,4,9,846
5/18/2022,,,15294,1233206,670,197,1249367,113,867,104,8,12,847
5/19/2022,,,15294,1233387,589,187,1249457,90,776,181,5,11,760
5/20/2022,,,15294,1233494,564,187,1249539,82,751,107,8,14,729
5/21/2022,,,15294,1233575,581,182,1249632,93,763,81,8,12,743
5/22/2022,,,15296,1233664,594,188,1249742,110,782,89,4,9,769
5/23/2022,,,15297,1233779,548,176,1249800,58,724,115,6,17,701
5/24/2022,,,15300,1233873,580,195,1249948,148,775,94,9,16,750
5/25/2022,,,15300,1233937,631,208,1250076,128,839,64,8,15,816
5/26/2022,,,15300,1234021,669,210,1250200,124,879,84,8,15,856
5/27/2022,,,15300,1234087,709,214,1250310,110,923,66,10,19,894
5/28/2022,,,15300,1234180,723,211,1250414,104,934,93,5,12,917
5/29/2022,,,15300,1234280,722,201,1250503,89,923,100,5,8,910
5/30/2022,,,15303,1234376,704,201,1250584,81,905,96,5,8,892
5/31/2022,,,15303,1234487,729,197,1250716,132,926,111,9,3,914
6/1/2022,,,15303,1234566,823,188,1250880,164,1011,79,9,2,1000
6/2/2022,,,15303,1234723,830,182,1251038,158,1012,157,9,4,999
6/3/2022,,,15303,1234863,850,195,1251211,173,1045,140,7,2,1036
6/4/2022,,,15303,1234976,913,192,1251384,173,1105,113,6,2,1097
6/5/2022,,,15303,1235069,1011,196,1251579,195,1207,93,5,2,1200
6/6/2022,,,15303,1235172,1064,187,1251726,147,1251,103,4,4,1243
6/7/2022,,,15303,1235274,1222,187,1251986,260,1409,102,1,7,1401
6/8/2022,,,15303,1235370,1417,184,1252274,288,1601,96,0,10,1591
6/9/2022,,,15303,1235508,1548,191,1252550,276,1739,138,0,12,1727
6/10/2022,,,15303,1235666,1715,199,1252883,333,1914,158,0,12,1902
6/11/2022,,,15303,1235838,1852,204,1253197,314,2056,172,0,10,2046
6/12/2022,,,15303,1236002,2000,214,1253519,322,2214,164,0,9,2205
6/13/2022,,,15304,1236184,2179,200,1253867,348,2379,182,0,14,2365
6/14/2022,,,15304,1236374,2446,260,1254384,517,2706,190,0,14,2692
6/15/2022,,,15304,1236528,2980,302,1255114,730,3282,154,0,15,3267
6/16/2022,,,15305,1236820,3346,339,1255810,696,3685,292,0,14,3671
6/17/2022,,,15305,1237109,3712,370,1256496,686,4082,289,0,20,4062
6/18/2022,,,15305,1237400,4122,402,1257229,733,4524,291,0,20,4504
6/19/2022,,,15308,1237676,4543,437,1257964,735,4980,276,0,18,4962
6/20/2022,,,15309,1238059,4844,453,1258665,701,5297,383,0,15,5282
6/21/2022,,,15311,1238392,5420,495,1259618,953,5915,333,0,15,5900
6/22/2022,,,15311,1238754,6276,503,1260844,1226,6779,362,0,15,6764
6/23/2022,,,15311,1239359,6714,514,1261898,1054,7228,605,0,34,7194
6/24/2022,,,15313,1240028,7301,522,1263164,1266,7823,669,0,56,7767
6/25/2022,,,15313,1240738,7596,562,1264209,1045,8158,710,0,43,8115
6/26/2022,,,15313,1241429,7931,591,1265264,1055,8522,691,0,41,8481
6/27/2022,,,15313,1242286,7901,602,1266102,838,8503,857,0,27,8476
6/28/2022,,,15314,1243032,8375,631,1267352,1250,9006,746,0,27,8979
6/29/2022,,,15314,1243738,8801,633,1268486,1134,9434,706,0,27,9407
6/30/2022,,,15315,1244833,8926,667,1269741,1255,9593,1095,0,27,9566
7/1/2022,,,15316,1245980,8829,716,1270841,1100,9545,1147,0,35,9510
7/2/2022,,,15317,1247144,8675,688,1271824,983,9363,1164,0,24,9339
7/3/2022,,,15320,1248357,8333,745,1272755,931,9078,1213,0,18,9060
